13
13
XXXXXXXXXXXEX
S     X   XOX
X XXX X X X X
X O     XXX X
XX XXXX X   X
X  XXXXXX XXX
X XX  O X  OX
X X  XX XXX X
X X  X  O X X
X X  XXXX X X
X XXO   X X X
X    X  XO  X
XXXXXXXXXXXXX
