13
13
XXXXXXXXXXXEX
YYYYYYXYYYXGX
XYXXXYXYXYXYX
XYAYYYYYXXXYX
XXYXXXXYXYYYX
XYYXXXXXXYXXX
XYXXYYCYXYYFX
XYXYYXXYXXXYX
XYXYYXYYDYXYX
XYXYYXXXXYXYX
XYXXBYYYXYXYX
XYYYYXYYXEYYX
XXXXXXXXXXXXX